MMMMMMMMMMMMMMMMMMMMMMMMMMMM
M@MMMMMMMMM..T.T.TMMMMMMMM@M
MMMMMMMMMM#...T...#MMMMMMMMM
MMMMMMMMMMMT.T.T..MMMMMMMMMM
MMMMMMMMMMM.T...T.MMMMMMMMMM
MMMMMMMMMMMT.T...TMMMMMMMMMM
MMMMMMMMMMM...T...MMMMMMMMMM
MMMMMMMMMMMT...T.TMMMMMMMMMM
MMMMMMMMMMM.T...T.MMMMMMMMMM
MMMMMMMMMMM..T.T.TMMMMMMMMMM
MMMMMMMMMMM=======MMMMMMMMMM
MMMMMMMMMMMT.T.T..MMMMMMMMMM
MMMMMMMMMMM.T...T.MMMMMMMMMM
MMMMMMMMMMMT.T...TMMMMMMMMMM
MMMMMMMMMMM...T...MMMMMMMMMM
MMMMMMMMMMMT...T.TMMMMMMMMMM
MMMMMMMMMMM.T...T.MMMMMMMMMM
MMMMMMMMMM#..T.T.T#MMMMMMMMM
MMMMMMMMMMM...T...MMMMMMMMMM
MMMMMMMMMMMMMMMMMMMMMMMMMMMM
