############################
#TTTTTT..........TTTTTTTTT#
#T....TT....TT.............#
#....TT...@....TT..........#
#..........PPPPP...........#
#..TT......PPPPP......TT...#
#..........PPPPP...........#
#..........====...........#
#..TT................TT...#
#..........................#
#.PPPP............PPPP.....#
#..........................#
#......TT....TT....TT......#
#..........................#
############################
