########################
#@PPPPPPPPPPP..........#
#...T.T...T.P...T......#
#..T.....T..P..T...T.T.#
#.T.....T...T.T.....T..#
#....T.T....PT.T...T...#
#.....T.T...T.....T....#
#....T...=======.T...T.#
#...T....=======T......#
#..T...T.=======.T...T.#
#.T.....T=======....T..#
#..T...T.=======...T...#
#.....T.....T...T.T....#
#....T...T.T.....T.T...#
#.T.T.....T.T...T......#
#..T.T...T.....T.....T.#
#......................#
########################
