################################
#..T.T.....T.T...T.....T.....T.#
#...T.T...T.....T.....T...T.T..#
#..T.....T.....T...T.T.....T.T.#
#.T.....T...T.T.....T.T...T....#
#T...T.T.....T.T...T.....T.....#
#.....T.T...T.....T.....T...T.T#
#T...T.....T.....T...T.T.....T.#
#...T.....T...T.T.....T.T...T..#
#..T...T.T.....T.T...T.....T...#
#.PP....T.T...T.P...T.....T...T#
#T.TPPPPPP...T..P..T...T.T.....#
#.....T...PPPPPPT.T.....T.T...T#
#....T...T.T....PPPPPP.T.....T.#
#.T.T.....T.T...T.....PPPPPPT..#
#..T.T...T.....TP....T...T.TPP.#
#.T.....T.....T.P.T.T.....T.T..#
#T.....T...T.T..P..T.T...T.....#
#@PPTPTPPPPPTPTPP.T.....T.....T#
################################
