####################
#@.T.T.....T.T...T.#
#...T.T...T.....T..#
#..T.....T.....T...#
#.T.....T...T.T....#
#T...T.T.PPP.T.T...#
#..W..W.TWP.W..W..W#
#WWWWWWWWWPWWWWWWWW#
#...T.....P...T.T..#
#..T...T.PPP...T.T.#
#.T.....T.T...T....#
#T.T...T.....T.....#
#@....T.....T...T.T#
####################
