########################
#@PPPTPTPTPPPT.T.T...T.#
#.T...T...T.P.T...T...T#
#..T.T.T...TPT.T...T.T.#
#...T...T...T...T...T..#
#T.T.T...T.TPT...T.T.T.#
#.T...T.####P####.T...T#
#T.T...T#.##P##.#T.T...#
#...TP..###TTT###...T..#
#TPPPTPP#.#TPT#.#T...T.#
#.T...T.###TTT###PT...T#
#..T.T.T#.##.##.#.PPPP.#
#...T...#########...T..#
#T.T.T...T.T.T...T.T.T.#
#.T...T...T...T...T...T#
#T.T...T.T.T...T.T.T...#
#...T...T...T...T...T..#
########################
