########################
#T....T....TPPPPTPPPPT@#
#.T....T....T....T....T#
#T.TT..TT.T.PT..T.TT..T#
#...T....T..P.T....T...#
#....T....T.P..T....T..#
#TT..TT.T..TP.T.TT..TT.#
#.T....T....T....T....T#
#..T.P..T...PT....T....#
#.PPP.PPPPPPT.TT..TT.T.#
#....T....T.PPPPPP..T..#
#T....T....T....T.PPPP.#
#TT.T..T..T.TT..TT.T..T#
#..T....T....T....T....#
#...T....T....T....T...#
#.T..T..T.TT..TT.T..T..#
#T....T....T....T....T.#
########################
