################################
#@........W...................@#
#.........W....................#
#.........W....................#
#.........W....................#
#....T....W.........T....T....T#
#PPP=PPP=====PP...PP=PPP=PPP=PP#
#..T....T.W..T....T....T....T..#
#.........W....................#
#.........W....................#
#.........W....................#
################################
