############################
#@...........TPT...........#
#............TP............#
#.............PT...........#
#............T=T...........#
#..........................#
#..........................#
#..........................#
#............T=............#
#.............PT...........#
#@...........TPT...........#
############################
