########################
#@.T.T.....T.T...T.....#
#...T.T...T.....T.....T#
#..T.....T.....T...T.T.#
#.T.....T.PPPPT.....T.T#
#T...T.T....PT.T...T...#
#WWWWWWWWWWWPWWWWWWWWWW#
#T...T.....TP....T...T.#
#...T.....PPPPT.T.....T#
#..T...T.T.....T.T...T.#
#.T@....T.T...T.....T@.#
########################
