################
#@.............#
#..............#
#....T....T....#
#PPP=PP...PP=PP#
#..T.........T.#
#.............@#
################
