############################
#@...........TPT...........#
#............TP............#
#.............PT...........#
#..........................#
#..........................#
#..........................#
#............TPT...........#
#@...........T=............#
############################
