########################
#@@.....W..............#
#.......W..............#
#.......W..............#
#....T..W.T....T....T..#
#PPP=PP====...PP=PPP=PP#
#..T....W.........T....#
#.......W..............#
#..@....W............@.#
########################
