####################################
#@................................@#
#..................................#
#..................................#
#..................................#
#....T....T....T....T....T....T....#
#PPP=PPP=PPP=PPP=...=PPP=PPP=PPP=PP#
#..T....T....T.........T....T....T.#
#..................................#
#..................................#
#.................................@#
####################################
