########################
#@....................@#
#......................#
#......................#
#....T....T....T....T..#
#PPP=PPP=PP...PP=PPP=PP#
#..T....T.........T....#
#......................#
#......................#
########################
