####################
#@................@#
#..................#
#..................#
#....T.........T...#
#PPP=PPP=...=PPP=PP#
#..T....T....T....T#
#..................#
#..................#
####################
