MMMMMMMMMMMMMMMMMMMMMMMM
M@MMMMMMMT...T.MMMMMMMMM
MMMMMMMM#.T...T#MMMMMMMM
MMMMMMMMM..T.T.MMMMMMMMM
MMMMMMMMM...T..MMMMMMMMM
MMMMMMMMMT.T.T.MMMMMMMMM
MMMMMMMMM.T...TMMMMMMMMM
MMMMMMMMM======MMMMMMMMM
MMMMMMMMM...T..MMMMMMMMM
MMMMMMMMMT...T.MMMMMMMMM
MMMMMMMMM.T...TMMMMMMMMM
MMMMMMMM#..T.T.#MMMMMMMM
M@MMMMMMM...T..MMMMMMMMM
MMMMMMMMMMMMMMMMMMMMMMMM
