MMMMMMMMMMMMMMMMMMMMMMMM
M@PPPPPPPPPPPPPPPPPPPP@M
MMMMMM##....P...##MMMMMM
MMMMMM##....P...##MMMMMM
MMMMMM##....P...##MMMMMM
MMMMMM##....P...##MMMMMM
MMMMMM##....P...##MMMMMM
MMMMMM#P========P#MMMMMM
MMMMMM##........##MMMMMM
MMMMMM##........##MMMMMM
MMMMMM##........##MMMMMM
MMMMMM##........##MMMMMM
MMMMMMMM........MMMMMMMM
MMMMMMMMMMMMMMMMMMMMMMMM
