MMMMMMMMMMMMMMMMMMMMMMMM
M@MMMMMMMT...T.MMMMMMM@M
MMMMMMMM#.T...T#MMMMMMMM
MMMMMMMMM..T.T.MMMMMMMMM
MMMMMMMMM...T..MMMMMMMMM
MMMMMMMMMT.T.T.MMMMMMMMM
MMMMMMMMM.T...TMMMMMMMMM
MMMMMMMMM======MMMMMMMMM
MMMMMMMMM...T..MMMMMMMMM
MMMMMMMMMT...T.MMMMMMMMM
MMMMMMMMM.T...TMMMMMMMMM
MMMMMMMM#..T.T.#MMMMMMMM
MMMMMMMMM...T..MMMMMMMMM
MMMMMMMMMMMMMMMMMMMMMMMM
