####################
#...T........T.....#
#.......T........T.#
#..T........T......#
#......T........T..#
#.T........T.......#
#.....T#######.T...#
#T.....#.....#.....#
#....T.#.TPT.#T....#
#......#..P..#....T#
#...T..###P###.PPP.#
#.......T.PPPPP..T.#
#..T.PPPPPP.T......#
#.PPP..T..P.....T..#
#@TPPPPPPPPT.......#
####################
