########################
#@PPPPTPPPPTP...T....T.#
#.##########P#########T#
#T#TT..TT.T.PT..T.TT.#T#
#.#.T....T..P.T....T.#.#
#.#..T....T.P..T....T#.#
#T#..TT.T..TP.T.TT..T#.#
#.#....T..=====..T...#T#
#.#T....T.=====...T..#.#
#.#PPPPPPP=====PPPPPP#.#
#.#..T....=====T....T#.#
#T#.P.T.P.=====.T....#.#
#T#.T..T..T.PT..TT.T.#T#
#.#T....T...PT....T..#.#
#.#.T....T..P.T....T.#.#
#.####################.#
#T....T....T....T....T.#
########################
