########################################
#@...........W........................@#
#............W.........................#
#............W.........................#
#............W.........................#
#....T....T..W.T.........T....T....T...#
#PPP=PPP=PPP=====PP...PP=PPP=PPP=PPP=PP#
#..T....T....W....T....T....T....T....T#
#............W.........................#
#............W.........................#
#............W.........................#
########################################
