############################
#@.T.T.....T.T...T.....T...#
#...T.T...T.....T.....T...T#
#..T.....T.....T...T.T.....#
#.T.....T...PPPP....T.T...T#
#T...T.T.....TPT...T.....T.#
#WWWWWWWWWWWWWPWWWWWWWWWWWW#
#T...T.....T..P..T...T.T...#
#...T.....T.PPPPT.....T.T..#
#..T...T.T.....T.T...T.....#
#@T.....T.T...T.....T.....T#
############################
