####################################
#@..........W.....................@#
#...........W......................#
#...........W......................#
#...........W......................#
#....T....T.W..T....T....T....T....#
#PPP=PPP=PP====P=...=PPP=PPP=PPP=PP#
#..T....T...WT.........T....T....T.#
#...........W......................#
#...........W......................#
#...........W......................#
####################################
