################################
#@............................@#
#..............................#
#..............................#
#..............................#
#....T....T.........T....T....T#
#PPP=PPP=PPP=PP...PP=PPP=PPP=PP#
#..T....T....T....T....T....T..#
#..............................#
#..............................#
#.............................@#
################################
