############################
#@.......W.................#
#........W.................#
#........W................@#
#........W.................#
#....T...WT.........T....T.#
#PPP=PPP=====...=PPP=PPP=PP#
#..T....TW........T....T...#
#........W.................#
#........W.................#
#........W................@#
############################
