########################
#...........PPPPPPPPPP@#
#.##########P#########.#
#.#........TP........#.#
#.#........TP........#.#
#.#........TP........#.#
#.#........TP........#.#
#.#TTTTTTT=====TTTTTT#.#
#.#.......=====......#.#
#.#PPPPPPP=====PPPPPP#.#
#.#.......=====......#.#
#.#.......=====......#.#
#.#........TP........#.#
#.#........TP........#.#
#.#TTTTTTTTTPTTTTTTTT#.#
#.####################.#
#......................#
########################
